#######################################################
#               #         #         #     #   #     # #
#         #         #   # #   #  ####   # ##  ######  #
#   ####        ##   ## #         #                   #
#  ##       ##   ## #  ####   #  #####  ####          #
#     ###   ####              #                   #   #
#  ####   ####     #####      #####        ###     #  #
#     # ####        #             #           #####   #
#  ## ###   #   #####   ###   #####   ######### # #   #
#           #                  #      #         #     #
##     ## #  ##   ###  ## #    #      #     ###  ######
#    ####         #            #       #              #
#   ##    #   #   ###  ##   #######  #    #  #  #  ####
#  ####                       #               #  #  # #
#   #####  #### ###    ###   ##  #  ###     ##   #### #
# #     #    ####   #            ###   ###       ###  #
# #     # ##  # ###   ##            ###   #   #   #   #
#       #     #               ###   #     #   #   #   #
# ####      #######    ######       #####   # ##  #   #
#     #        ####          ###           #       #  #
#######################################################
