#######################################################
##        #         #         #     #   #     #       #
##   ###  #         #   # #   #  ####   # ##  ######  #
#         # ##   ## #         #                       #
#  ######       ##   ## #  ####   #     ##    ####    #
#                      #                      # #     #
#  ##   ####     #####      #####     ####      #     #
#     #         #             #                 # #   #
#  ## ###   #   #####   ###   #####   ######### # #   #
#           #                         #         #     #
######   ##   #### #####     #  #####     ####      ###
#             #                                       #
#   #######   #     ###  ##  ######       #  #  #  ####
#                         #               #  #  #     #
#               ###   ##  #  ###     ##   ####  #     #
# #     #       #                                     #
# #     # ##  # ###   ##            ###   #   #   #   #
#             #               ###   #     #   #   #   #
#       ####  #    #######  #####   # ##  #   #       #
#                                       #         #   #
#######################################################
